...........
.OOOOOOOOO.
.O.......O.
.OOOOOO..O.
.O....O..O.
.O....@..O.
.OOOOOOOOO.
...........