S..........
OOOOOOOOOO.
OO.OOOO..O.
.OOOOOO..O.
.O....O..O.
.O....O..O.
.OOOOOOOOF.
...........