.........................
.OOOOOOOOOOOOOOOOOOOOOOO.
.O.....................O.
.O.....................O.
.O.....................O.
.O.....................O.
.OOOOOOOOOOOOOOOOOOOOOOO.
.........................