.........................
.EOOOOEOOOOOOOEEOOOOEOOF.
.O..O.....O..OO...OO...O.
.O..O..OO.....O..OO...O..
.O..OOOOOOEOOOOOOO....O..
.O....OO........OO.....O.
.SOOOOOOO...OOOOOOOOOOOO.
.........................