..............
.OOOOO..OOOOO.
.O...O..O...O.
.O...OOOO...O.
.O...O..O...O.
.OOOOO..OOOOO.
...O......O...
...OO....OO...
....OOOOOO....
..............