..............
.SOOOO..OOOOO.
.O...O..O...O.
.O...OPPOOO.O.
.O...O..O...O.
.OOOOO..OOOOF.
...OO.....OO...
...PO....OP...
....OOOOOO....
......OOOOO...