..............
.@OEOO..OOEOO.
.P...E..O...O.
.P...POOP...P.
.P...P..P...P.
.PPEPP..PPEP@.
...O......O...
...OO....OO...
....OOOOOO....
..............